Constituency No,S.N.,Candidate,Party,EVM Votes,Postal Votes,Total Votes
1,1,ARUNA,Indian National Congress,6724,58,6782
1,2,RAJ KARAN KHATRI,Bharatiya Janata Party,86463,752,87215
1,3,SHARAD KUMAR,Aam Aadmi Party,78395,224,78619
1,4,ANIL KUMAR SINGH,Communist Party of India (Marxist-Leninist) (Liberation),328,0,328
1,5,MD KHALID,Aazad Samaj Party (Kanshi Ram),278,0,278
1,6,BUDIYA,Independent,242,0,242
1,7,VIKAS BHARDWAJ,Independent,300,1,301
1,8,NOTA,None of the Above,973,8,981
2,1,GANGA RAM,Bahujan Samaj Party,2193,21,2214
2,2,MANGESH TYAGI,Indian National Congress,19808,112,19920
2,3,SANJEEV JHA,Aam Aadmi Party,120813,368,121181
2,4,ANIL KAPOOR,Janhit Dal,866,3,869
2,5,ABHISHEK KUMAR SINGH (MASTER JI),Rashtriya Janshakti Party (Secular),530,1,531
2,6,GULAB SINGHAL,Bhim Sena,318,0,318
2,7,DHURVA KUMAR,Right to Recall Party,224,0,224
2,8,PRAMOD,Sarvodaya Prabhat Party,315,0,315
2,9,MUKESH PRASAD,Bhartiya Janta Dal (Integrated),284,4,288
2,10,RATAN TYAGI,Nationalist Congress Party,3829,23,3852
2,11,VIJAY KUMAR JHA,Rachnatmak Jan Morcha,589,0,589
2,12,SHAILENDRA KUMAR,Janata Dal (United),99943,637,100580
2,13,SUNIL KUMAR VYATHIT,Aam Aadmi Sangharsh Party (S),568,1,569
2,14,SONU KAUSHIK,Aapki Apni Party (Peoples),738,1,739
2,15,NOTA,None of the Above,2530,18,2548
3,1,LOKENDRA KALYAN SINGH,Indian National Congress,8313,48,8361
3,2,SURINDER PAL SINGH (BITTOO),Aam Aadmi Party,54602,171,54773
3,3,SURENDER PAL,Bahujan Samaj Party,976,9,985
3,4,SURYA PRAKASH KHATRI,Bharatiya Janata Party,55626,315,55941
3,5,TARUN KUMAR,Republican Sena,165,2,167
3,6,DEEPAK CHAWLA,Republican Party of India (Athawale),113,0,113
3,7,BIJENDER KUMAR,Jan Samuh Party,49,1,50
3,8,RAKESH RANJAN SHRIVASTAV,Janhit Dal,90,1,91
3,9,RAJKUMAR BHARTI,Peoples Party of India (Democratic),111,1,112
3,10,RAM RAJ SINGH,Rashtriya Janshakti Party (Secular),109,0,109
3,11,WASIM AKRAM,Indian National Socialistic Action Forces,69,0,69
3,12,SANGH PRIYA SIDDHARTHA,Bhim Sena,107,0,107
3,13,NOTA,None of the Above,658,5,663
4,1,ABDUL ZABBAR,Bahujan Samaj Party,343,1,344
4,2,MUKESH KUMAR GOEL,Aam Aadmi Party,40941,87,41028
4,3,RAJ KUMAR BHATIA,Bharatiya Janata Party,52260,250,52510
4,4,SHIVANK SINGAL,Indian National Congress,5442,18,5460
4,5,PRIYA,"Aam Janmat Party,",56,0,56
4,6,PREM CHAND,Rashtrawadi Janlok Party (Satya),41,0,41
4,7,MD: RAHMAT ALI,Navarang Congress Party,18,0,18
4,8,VISHAL SINGH,National Youth Party,27,0,27
4,9,SANJAY YADAV ADVOCATE,Peoples Party of India (Democratic),35,0,35
4,10,SANJEEV KUMAR RANA,Communist Party of India,133,0,133
4,11,AYUSH GUPTA,Independent,64,0,64
4,12,NEETU SINGH,Independent,111,0,111
4,13,RAM NIWAS,Independent,140,0,140
4,14,VIJAY KR. AGGARWAL,Independent,116,0,116
4,15,NOTA,None of the Above,374,3,377
5,1,AJESH YADAV,Aam Aadmi Party,45937,92,46029
5,2,AAHIR DEEPAK CHAUDHARYY,Bharatiya Janata Party,61011,181,61192
5,3,DEVENDER YADAV,Indian National Congress,40980,91,41071
5,4,RAVINDER KUMAR,Bahujan Samaj Party,723,2,725
5,5,GOPAL KUMAR SINHA,Bharatiya Sampuran Krantikari Party,76,0,76
5,6,PARMOD KUMAR,Socialist Unity Centre Of India (COMMUNIST),250,0,250
5,7,MULAYAM SINGH,Nationalist Congress Party,92,0,92
5,8,RAJENDER,"Aam Janmat Party,",68,0,68
5,9,R. C. SHARMA,Sarvodaya Prabhat Party,64,0,64
5,10,ARUN KUMAR,Independent,158,0,158
5,11,JAI PAL,Independent,214,0,214
5,12,DEVENDER KUMAR YADAV,Independent,235,0,235
5,13,NOTA,None of the Above,687,5,692
6,1,KULWANT RANA,Bharatiya Janata Party,103950,421,104371
6,2,NEYAZ KHAN,Bahujan Samaj Party,615,4,619
6,3,MOHINDER GOYAL,Aam Aadmi Party,74591,164,74755
6,4,SUSHANT MISHRA,Indian National Congress,5216,42,5258
6,5,ASHOK JAIN,Yuva Bharat Rashtraseva Party,213,0,213
6,6,AYASHA KHATOON,Peoples Party of India (Democratic),114,0,114
6,7,JITANDER SINGH,Asankhya Samaj Party,55,1,56
6,8,NISHTHA,Jai Maha Bharath Party,154,1,155
6,9,AJAY KUMAR SINGH,Independent,104,0,104
6,10,VIDYA PATTI,Independent,167,0,167
6,11,VISHAL GUPTA,Independent,117,0,117
6,12,NOTA,None of the Above,1224,11,1235
7,1,JAI BHAGWAN UPKAR,Aam Aadmi Party,87874,166,88040
7,2,RAVINDER INDRAJ SINGH,Bharatiya Janata Party,118746,769,119515
7,3,SURENDER KUMAR,Indian National Congress,18630,83,18713
7,4,HEERA LAL,Bahujan Samaj Party,1552,5,1557
7,5,DHEERAJ KUMAR,Peoples Party of India (Democratic),216,0,216
7,6,BABITA,Asankhya Samaj Party,188,2,190
7,7,HARI KISHAN MECHANIC,Independent,278,1,279
7,8,NOTA,None of the Above,1339,7,1346
8,1,GAJENDER DRALL,Bharatiya Janata Party,89128,711,89839
8,2,JASBIR KARALA,Aam Aadmi Party,79062,227,79289
8,3,DHARAMPAL LAKRA,Indian National Congress,10241,49,10290
8,4,SUMAN LATA SEHRAWAT,Bahujan Samaj Party,544,4,548
8,5,MAHAVIR,All India Forward Bloc,93,1,94
8,6,YOGENDER SINGH ALIAS YOGI MATHUR,Akhil Bharatiya Socialist Party,86,1,87
8,7,SUNIL KUMAR,National Loktantrik Party,165,1,166
8,8,SANJAYA KUMAR YADAV,Right to Recall Party,61,0,61
8,9,SANTOSH,Indian National Socialistic Action Forces,84,0,84
8,10,ANDEEP DRALL,Independent,112,3,115
8,11,RAJNI,Independent,128,1,129
8,12,RAMBIR SHOKEEN,Independent,8621,34,8655
8,13,SUNITA SHEKHAR CHAWARIYA,Independent,408,0,408
8,14,NOTA,None of the Above,1076,12,1088
9,1,ANIL JHA,Aam Aadmi Party,105660,120,105780
9,2,JUGBIR SINGH,Bahujan Samaj Party,2116,12,2128
9,3,BAJRANG SHUKLA,Bharatiya Janata Party,83749,160,83909
9,4,RAJESH KUMAR GUPTA,Indian National Congress,6847,17,6864
9,5,AFSANA SARWAR,Peace Party,208,0,208
9,6,MALIK NEYAZ AHMAD,Aazad Samaj Party (Kanshi Ram),885,0,885
9,7,SUDESH SHARMA,Rashtriya Manav Party,212,0,212
9,8,PRAKASH SRIVASTAV,Independent,588,0,588
9,9,RAKESH,Independent,472,1,473
9,10,NOTA,None of the Above,1363,3,1366
10,1,KARAM SINGH KARMA,Bharatiya Janata Party,41549,92,41641
10,2,KULWANT RANA,Bahujan Samaj Party,1882,3,1885
10,3,JAI KISHAN,Indian National Congress,8671,17,8688
10,4,MUKESH KUMAR AHLAWAT,Aam Aadmi Party,58687,80,58767
10,5,KARAN SINGH,Swaraj Bhartiya Nyay Party,151,0,151
10,6,JITENDER,Jai Maha Bharath Party,555,0,555
10,7,PREETI,Yuva Bharat Rashtraseva Party,82,0,82
10,8,BABU LAL,Bharatiya Sampuran Krantikari Party,91,0,91
10,9,LAXMI,Republican Party of India (Athawale),70,0,70
10,10,SANGEETA,Rashtriya Lok Sevak Party,72,0,72
10,11,DEEPAK KUMAR,Independent,177,0,177
10,12,RAMSWAROOP SAMRIA,Independent,150,2,152
10,13,NOTA,None of the Above,488,6,494
11,1,MANOJ KUMAR SHOKEEN,Bharatiya Janata Party,74950,322,75272
11,2,MUKESH KUMAR,Bahujan Samaj Party,792,3,795
11,3,RAGHUVINDER SHOKEEN,Aam Aadmi Party,48907,114,49021
11,4,ROHIT CHOUDHARY,Indian National Congress,31918,110,32028
11,5,KANCHAN SHARMA,Rashtriya Manav Party,162,0,162
11,6,MAHENDER SINGH RATHOR,Rashtriya Lok Sevak Party,152,0,152
11,7,YATENDER SHARMA,Azad Adhikar Sena,389,1,390
11,8,RAM SAJIVAN,Peoples Party of India (Democratic),204,1,205
11,9,DILIP KUMAR SHARMA,Independent,373,0,373
11,10,NOTA,None of the Above,915,9,924
12,1,DHARAM RAKSHAK ALIAS RAKESH JATAV,Aam Aadmi Party,55659,93,55752
12,2,MUKESH KUMAR,Bahujan Samaj Party,721,3,724
12,3,RAJ KUMAR CHAUHAN,Bharatiya Janata Party,61805,202,62007
12,4,HANUMAN SAHAY ALIAS HANUMAN CHAUHAN,Indian National Congress,3761,23,3784
12,5,KHILKHILAKAR,Bahujan Shoshit Samaj Sangharsh Samta Party,171,0,171
12,6,JAI BHAGWAN,Independent,250,0,250
12,7,NOTA,None of the Above,760,2,762
13,1,PARDEEP MITTAL,Aam Aadmi Party,32442,107,32549
13,2,VIJENDER GUPTA,Bharatiya Janata Party,69890,475,70365
13,3,SUMESH GUPTA,Indian National Congress,3721,44,3765
13,4,HARSHAD CHADHA,Bahujan Samaj Party,194,3,197
13,5,ABHISHEK,Jai Maha Bharath Party,118,0,118
13,6,AMIT SAINI,Jan Samuh Party,91,1,92
13,7,NARENDER SINGH PANWAR,Independent,52,2,54
13,8,RAJBIR,Independent,62,0,62
13,9,NOTA,None of the Above,1027,4,1031
14,1,PARVEEN KUMAR JAIN,Indian National Congress,4845,47,4892
14,2,BANDANA KUMARI,Aam Aadmi Party,38487,118,38605
14,3,REKHA GUPTA,Bharatiya Janata Party,67839,361,68200
14,4,SHYAM KUMAR,Bahujan Samaj Party,410,1,411
14,5,RANJEET VERMA,New India United Party,35,0,35
14,6,MOHD. USMAN,Independent,98,0,98
14,7,RAJESH KUMAR,Independent,143,0,143
14,8,RINA DEVI,Independent,252,0,252
14,9,SAURABH GUPTA,Independent,356,2,358
14,10,NOTA,None of the Above,768,2,770
15,1,KARNAIL SINGH,Bharatiya Janata Party,56570,299,56869
15,2,SATISH KUMAR LUTHRA,Indian National Congress,5736,48,5784
15,3,SATYENDAR JAIN,Aam Aadmi Party,35775,96,35871
15,4,VIJAY KUMAR,Bahujan Samaj Party,164,0,164
15,5,TAMANA,Yuva Bharat Rashtraseva Party,115,0,115
15,6,RAJESH GUPTA,Bharat Lok Sewak Party,99,1,100
15,7,JUGAL CHAWLA,Independent,76,0,76
15,8,NOTA,None of the Above,672,1,673
16,1,TILAK RAM GUPTA,Bharatiya Janata Party,58836,237,59073
16,2,PAWAN GARG,Bahujan Samaj Party,562,4,566
16,3,PREETI JITENDER TOMAR,Aam Aadmi Party,43083,94,43177
16,4,SATENDER SHARMA,Indian National Congress,6867,30,6897
16,5,SUBHASH,Asankhya Samaj Party,180,1,181
16,6,SURENDRA SINGH BASOYA,Peoples Party of India (Democratic),114,1,115
16,7,NOTA,None of the Above,682,6,688
17,1,POONAM SHARMA,Bharatiya Janata Party,54414,307,54721
17,2,RAGINI NAYAK,Indian National Congress,6311,37,6348
17,3,RAJESH GUPTA,Aam Aadmi Party,43194,102,43296
17,4,HIRA LAL,Bahujan Samaj Party,1046,1,1047
17,5,DEVENDER KUMAR,Communist Party of India,190,0,190
17,6,MAHESH BANSAL,Right to Recall Party,64,0,64
17,7,SHEELA DEVI,Garib Ekta Party,63,0,63
17,8,AAKASH GOEL,Independent,233,1,234
17,9,MUKESH JAIN,Independent,173,0,173
17,10,NOTA,None of the Above,652,0,652
18,1,AKHILESH PATI TRIPATHI,Aam Aadmi Party,38608,85,38693
18,2,ASHOK GOEL,Bharatiya Janata Party,51848,260,52108
18,3,KANWAR KARAN SINGH,Indian National Congress,3886,22,3908
18,4,CHUNNI LAL,Bahujan Samaj Party,372,0,372
18,5,AWDHESH KUMAR JHA,Right to Recall Party,33,0,33
18,6,PANKAJ KUMAR,Rashtravadi Janata Party,58,0,58
18,7,VIVEK GIRI,Aapki Apni Party (Peoples),118,0,118
18,8,CHANDER PAL,Independent,119,0,119
18,9,ROMAN RASHID,Independent,224,0,224
18,10,NOTA,None of the Above,682,3,685
19,1,ANIL BHARDWAJ,Indian National Congress,10022,35,10057
19,2,MANOJ KUMAR JINDAL,Bharatiya Janata Party,49671,199,49870
19,3,SHAIL KUMARI,Bahujan Samaj Party,708,1,709
19,4,SOM DUTT,Aam Aadmi Party,56070,107,56177
19,5,ANITA BANSAL,Asankhya Samaj Party,123,0,123
19,6,ASHA RANI,Socialist Unity Centre Of India (COMMUNIST),184,0,184
19,7,UMESH RATHOR,Atulya Bharat Party,49,1,50
19,8,MADHU BALA,Jai Maha Bharath Party,213,0,213
19,9,MEENAKSHI KUMARI,Bharatiya Liberal Party,247,0,247
19,10,LAXMI THAKUR SINGHAL,Abhinav Bharat Party,84,0,84
19,11,CA SOHARSH GULGULIA JAIN,Jantantrik Samta Party,100,0,100
19,12,NOTA,None of the Above,584,2,586
20,1,KALI CHARAN,Bahujan Samaj Party,246,0,246
20,2,PUNARDEEP SINGH SAWHNEY (SABBY),Aam Aadmi Party,38932,61,38993
20,3,MUDIT AGARWAL,Indian National Congress,9038,27,9065
20,4,SATISH JAIN,Bharatiya Janata Party,22359,62,22421
20,5,KHALID UR REHMAN,Nationalist Congress Party,81,0,81
20,6,MOHAMMAD MURSALEEN,Indian National Socialistic Action Forces,45,0,45
20,7,RAHUL TIWARI,Right to Recall Party,69,0,69
20,8,NOTA,None of the Above,249,4,253
21,1,AALEY MOHAMMED IQBAL,Aam Aadmi Party,58041,79,58120
21,2,ASIM AHMED KHAN,Indian National Congress,10274,21,10295
21,3,TEJ RAM,Bahujan Samaj Party,129,1,130
21,4,DEEPTI INDORA,Bharatiya Janata Party,15351,45,15396
21,5,MOHD JAVED,Nationalist Congress Party,56,0,56
21,6,AMAR NATH,Independent,93,0,93
21,7,ZAINUDDIN,Independent,10,1,11
21,8,FIRDOUS AHMAD,Independent,31,0,31
21,9,BHAGWAN DASS,Independent,35,0,35
21,10,MOHAMMAD AHMED SAIFI,Independent,60,0,60
21,11,MOAZAM KHAN,Independent,31,0,31
21,12,NOTA,None of the Above,217,0,217
22,1,IMRAN HUSSAIN,Aam Aadmi Party,56932,72,57004
22,2,KAMAL BAGRI,Bharatiya Janata Party,27119,62,27181
22,3,SONU,Bahujan Samaj Party,190,0,190
22,4,HAROON YUSUF,Indian National Congress,13038,21,13059
22,5,ABRAR,Aam Aadmi Parivartan Party,224,0,224
22,6,MD HAROON,Nationalist Congress Party,38,0,38
22,7,BABU LAL,Independent,130,1,131
22,8,MOHD. SHADAB,Independent,72,0,72
22,9,HANSA,Independent,77,0,77
22,10,NOTA,None of the Above,299,2,301
23,1,DUSHYANT GAUTAM,Bharatiya Janata Party,44750,117,44867
23,2,RAHUL KUMAR,Indian National Congress,4232,20,4252
23,3,RANJEET,Bahujan Samaj Party,624,2,626
23,4,VISHESH RAVI,Aam Aadmi Party,52153,144,52297
23,5,SHIV KUMAR,Rashtriya Aikta Manch Party,116,0,116
23,6,DEEPAK KUMAR,Independent,87,1,88
23,7,NOTA,None of the Above,543,5,548
24,1,KRISHNA TIRATH,Indian National Congress,4610,44,4654
24,2,PRAVESH RATN,Aam Aadmi Party,57408,104,57512
24,3,RAAJ KUMAR ANAND,Bharatiya Janata Party,53273,190,53463
24,4,RAM AVTAR,Bahujan Samaj Party,712,2,714
24,5,ASHOK KUMAR,Aazad Samaj Party (Kanshi Ram),255,0,255
24,6,NOTA,None of the Above,768,4,772
25,1,AVINASH GUPTA,Bahujan Samaj Party,848,3,851
25,2,RAJENDER SINGH,Indian National Congress,3316,18,3334
25,3,SHIVCHARAN GOEL,Aam Aadmi Party,45827,81,45908
25,4,HARISH KHURANA,Bharatiya Janata Party,57364,201,57565
25,5,GOURAV BOTHRA,Right to Recall Party,124,0,124
25,6,MAHESH DUBEY,Bharatiya Liberal Party,35,0,35
25,7,VIJAY KUMAR SHARMA,Rashtriya Manav Party,63,0,63
25,8,VISHAL SAHNI,Voters Party International,70,0,70
25,9,SANAULLAH,Nationalist Congress Party,60,0,60
25,10,GAURI SHANKAR,Independent,170,0,170
25,11,SADRE ALAM,Independent,415,1,416
25,12,HARISH,Independent,76,0,76
25,13,NOTA,None of the Above,687,2,689
26,1,KAILASH GANGWAL,Bharatiya Janata Party,51824,195,52019
26,2,J. P. PANWAR,Indian National Congress,17878,80,17958
26,3,RAKHI BIRLA,Aam Aadmi Party,41034,86,41120
26,4,ROOP SINGH AHIRWAR,Bahujan Samaj Party,319,2,321
26,5,RANDHIR KUMAR,Asankhya Samaj Party,66,0,66
26,6,RANDHIR SINGH TANDI,Jai Maha Bharath Party,204,0,204
26,7,ROHIT KASHYAP,Hamara Sahi Vikalp Party,105,0,105
26,8,DHARAMVEER,Independent,206,0,206
26,9,RAVI,Independent,113,0,113
26,10,NOTA,None of the Above,773,5,778
27,1,A DHANWATI CHANDELA A,Aam Aadmi Party,45835,107,45942
27,2,DHARAM PAL CHANDELA,Indian National Congress,3171,27,3198
27,3,MANJINDER SINGH SIRSA,Bharatiya Janata Party,63883,249,64132
27,4,SHASHI PABHA,Bahujan Samaj Party,286,2,288
27,5,KAMLA DEVI,Aapki Apni Party (Peoples),64,1,65
27,6,KARAN TALWAR,Aam Aadmi Parivartan Party,225,0,225
27,7,JAYA RAMAN,Sanjhi Virasat Party,89,0,89
27,8,VISHAL SANGWAN,Right to Recall Party,84,0,84
27,9,NOTA,None of the Above,778,5,783
28,1,PREM BALLABH,Indian National Congress,4175,77,4252
28,2,BINDU KUMAR,Bahujan Samaj Party,566,3,569
28,3,SHYAM SHARMA,Bharatiya Janata Party,49608,571,50179
28,4,SURINDER KUMAR SETIA,Aam Aadmi Party,43262,285,43547
28,5,PREETAM CHAND,Rashtriya Janshakti Party (Secular),81,0,81
28,6,MOHAN LAL BHARDWAJ,Bharatheeya Jawan Kisan Party,83,0,83
28,7,ASHOK KUMAR,Independent,28,1,29
28,8,MAYANK MEHTA,Independent,98,0,98
28,9,RAJ KUMARI DHILLON,Independent,3367,31,3398
28,10,SABIR KHAN,Independent,89,2,91
28,11,NOTA,None of the Above,705,8,713
29,1,ASHOK KUMAR GAUTAM,Bahujan Samaj Party,296,5,301
29,2,JARNAIL SINGH,Aam Aadmi Party,51955,179,52134
29,3,PARVINDER SINGH ALIAS P S BAWA,Indian National Congress,2716,31,2747
29,4,SHVETA SAINI,Bharatiya Janata Party,40233,245,40478
29,5,RAJIV KUMAR BABBAR,Independent,91,0,91
29,6,SHWETA,Independent,145,0,145
29,7,NOTA,None of the Above,600,7,607
30,1,ASHISH SOOD,Bharatiya Janata Party,68564,422,68986
30,2,PARVEEN KUMAR,Aam Aadmi Party,50045,175,50220
30,3,RAVI PARTAP RAO,Bahujan Samaj Party,458,3,461
30,4,HARBANI KAUR,Indian National Congress,3305,40,3345
30,5,KASHMIR CHAND,Buland Bharat Party,47,1,48
30,6,CHAMAN LAL VERMA,Aam Janshakti Party,69,1,70
30,7,DHARAM VEER,Suheldev Bharatiya Samaj Party,61,0,61
30,8,MD NAVEEN,Nationalist Congress Party,80,0,80
30,9,NIZAMUDDIN KHAN,Adarshwaadi Congress Party,43,0,43
30,10,MOHD OJER,Azad Adhikar Sena,91,0,91
30,11,RAJ KUMAR,All India National Raksha Sena,20,0,20
30,12,ALTAF AHMAD,Independent,182,1,183
30,13,ASHISH SOOD,Independent,56,1,57
30,14,TARUN KUMAR SHARMA,Independent,60,0,60
30,15,PRAVEEN KUMAR,Independent,193,0,193
30,16,PRAVEEN KUMAR,Independent,210,0,210
30,17,NOTA,None of the Above,684,7,691
31,1,KRISHNA THAKUR,Bahujan Samaj Party,2563,10,2573
31,2,JITENDER SOLANKI,Indian National Congress,8279,68,8347
31,3,PANKAJ KUMAR SINGH,Bharatiya Janata Party,132447,526,132973
31,4,MAHINDER YADAV,Aam Aadmi Party,119340,269,119609
31,5,UMESH CHAUHAN,Aazad Samaj Party (Kanshi Ram),438,0,438
31,6,PREM PAL SINGH,Rashtriya Janshakti Party (Secular),94,0,94
31,7,RAJU RICHARIYA,Rashtriya Rashtrawadi Party,68,0,68
31,8,RANJEET KUMAR,Rashtriya Manav Party,137,0,137
31,9,LALA RAM,Bhartiya Panchsheel Party,293,0,293
31,10,SHARDA DIXIT,Socialist Unity Centre Of India (COMMUNIST),412,0,412
31,11,SHEJO VARGHESE,Communist Party of India,668,2,670
31,12,AMAN SAINI,Independent,281,0,281
31,13,HIRA LAL SAH,Independent,384,1,385
31,14,NOTA,None of the Above,1432,8,1440
32,1,PAWAN SHARMA,Bharatiya Janata Party,103137,476,103613
32,2,POSH BALYAN,Aam Aadmi Party,73705,168,73873
32,3,MANI RAM,Bahujan Samaj Party,983,8,991
32,4,MUKESH SHARMA,Indian National Congress,15474,91,15565
32,5,DUSHYANT THAKUR,Yuva Bharat Rashtraseva Party,185,0,185
32,6,RAJIV BHRIGUKUMAR,Rashtriya Lok Janshakti Party,79,0,79
32,7,SHYAM BABU,Gareeb Aadmi Party,168,0,168
32,8,DINESH KUMAR SAH,Independent,204,2,206
32,9,JOURNALIST RAMESH KUMAR JAIN @ NIRBHIK,Independent,196,0,196
32,10,NOTA,None of the Above,1209,8,1217
33,1,ADARSH SHASTRI,Indian National Congress,6723,50,6773
33,2,PARDEEP KUMAR,Bahujan Samaj Party,541,4,545
33,3,PARDUYMN SINGH RAJPUT,Bharatiya Janata Party,68832,305,69137
33,4,VINAY MISHRA,Aam Aadmi Party,61136,172,61308
33,5,ARAVENDRA KUMAR,Suheldev Bharatiya Samaj Party,131,0,131
33,6,G. THULASEEDHARAN,Peoples Green Party,58,0,58
33,7,MEHAR CHARAN,Samaj Vikas Kranti Party,76,0,76
33,8,YOGESH SWAMI,Right to Recall Party,44,0,44
33,9,RAJNEESH KUMAR JHA,National Youth Party,130,0,130
33,10,RAVI RATHORE,Republican Sena,73,1,74
33,11,RAMESHWAR MAHTO,Rashtriya Manav Party,223,0,223
33,12,ASHOK JINDAL,Independent,172,0,172
33,13,GAUTAM SINGH BIHARI,Independent,104,0,104
33,14,NOTA,None of the Above,725,4,729
34,1,KAMLESH KUMAR,Bahujan Samaj Party,1116,18,1134
34,2,RAGHVINDER SINGH,Indian National Congress,9565,120,9685
34,3,SUMESH SHOKEEN,Aam Aadmi Party,117042,530,117572
34,4,SANDEEP SEHRAWAT,Bharatiya Janata Party,144938,1357,146295
34,5,ARVIND KUMAR PANDEY,Rashtriya Janshakti Party (Secular),345,0,345
34,6,NIRAJ KUMAR,National Youth Party,73,0,73
34,7,PRABHAT KUMAR,One Bharat Citizen Party,157,5,162
34,8,MOHINDER SINGH,Rashtriya Rashtrawadi Party,88,0,88
34,9,YOGESH KUMAR SHARMA,Right to Recall Party,121,0,121
34,10,VINOD KUMAR CHAUHAN,Suheldev Bharatiya Samaj Party,156,1,157
34,11,PUNAM PANDEY,Independent,498,3,501
34,12,YOGESH KUMAR,Independent,569,0,569
34,13,RAJNI SHARMA,Independent,174,0,174
34,14,NOTA,None of the Above,1994,24,2018
35,1,TARUN KUMAR,Aam Aadmi Party,72024,675,72699
35,2,NEELAM PAHALWAN,Bharatiya Janata Party,100058,1650,101708
35,3,ROHIT,Bahujan Samaj Party,873,30,903
35,4,SUSHMA DEVI YADAV,Indian National Congress,2839,63,2902
35,5,JALANDHAR PANDIT,"Proutist Bloc, India",210,4,214
35,6,BHARAT SINGH,Peoples Party of India (Democratic),88,5,93
35,7,RAHUL KUMAR,Right to Recall Party,70,1,71
35,8,MANOJ KUMAR,Independent,173,0,173
35,9,MANGE RAM SANGWAN,Independent,222,3,225
35,10,NOTA,None of the Above,1317,29,1346
36,1,KAMAL SINGH,Bahujan Samaj Party,698,4,702
36,2,KAILASH GAHLOT,Bharatiya Janata Party,64587,364,64951
36,3,COL DEVINDER KUMAR SEHRAWAT,Indian National Congress,9334,75,9409
36,4,SURENDER BHARDWAJ,Aam Aadmi Party,53462,213,53675
36,5,NARENDER SINGH,Republican Sena,96,0,96
36,6,NAVEEN KUMAR,Hamara Sahi Vikalp Party,91,0,91
36,7,PUNAM PANDEY,Rashtravadi Loktantrik Party (India),153,0,153
36,8,LALITA TRIVEDI,Bhartiya Krishak Dal,48,0,48
36,9,AMRINA,Independent,113,0,113
36,10,NISHANT SEHRAWAT,Independent,192,1,193
36,11,MONIS KURESHI,Independent,225,0,225
36,12,SOM DUTT SHARMA,Independent,91,1,92
36,13,NOTA,None of the Above,755,1,756
37,1,KULDEEP SOLANKI,Bharatiya Janata Party,81589,457,82046
37,2,GEETA,Bahujan Samaj Party,805,5,810
37,3,JOGINDER SOLANKI,Aam Aadmi Party,72844,250,73094
37,4,MANGE RAM,Indian National Congress,4655,42,4697
37,5,DILIP KUMAR,Communist Party of India,325,1,326
37,6,MANU GAUTAM,Peoples Party of India (Democratic),220,1,221
37,7,PRASHANT CHAUHAN,Independent,301,1,302
37,8,NOTA,None of the Above,1109,10,1119
38,1,NAMIT KUMAR GAUTAM,Bahujan Samaj Party,232,0,232
38,2,PRADEEP KUMAR UPMANYU,Indian National Congress,4230,22,4252
38,3,BHUVAN TANWAR,Bharatiya Janata Party,20073,89,20162
38,4,VIRENDER SINGH KADIAN,Aam Aadmi Party,22140,51,22191
38,5,SACHIN,Bharatiya Sampuran Krantikari Party,70,0,70
38,6,SURENDER KUMAR,Peoples Party of India (Democratic),72,0,72
38,7,ASHOK AGYANI,Independent,149,0,149
38,8,NOTA,None of the Above,327,3,330
39,1,UMANG BAJAJ,Bharatiya Janata Party,46391,280,46671
39,2,DURGESH PATHAK,Aam Aadmi Party,45290,150,45440
39,3,VINEET YADAV,Indian National Congress,3995,20,4015
39,4,SHIV PRASAD VERMA,Bahujan Samaj Party,147,3,150
39,5,PANKAJ JAGYA,Republican Party of India (Athawale),65,0,65
39,6,PRAVEEN KUMAR BHARTI,Aazad Samaj Party (Kanshi Ram),155,0,155
39,7,UMANG,Independent,143,1,144
39,8,NOTA,None of the Above,565,6,571
40,1,ARVIND KEJRIWAL,Aam Aadmi Party,25865,134,25999
40,2,PARVESH SAHIB SINGH,Bharatiya Janata Party,29878,210,30088
40,3,VIRENDER,Bahujan Samaj Party,142,0,142
40,4,SANDEEP DIKSHIT,Indian National Congress,4531,37,4568
40,5,ARUN KUMAR SHARMA,Delhi Janta Party,21,0,21
40,6,ISHWAR CHAND,Bharatrashtra Democratic Party,4,0,4
40,7,JAGDEESH PRASAD,Samarth Bharatvarsh Party,22,0,22
40,8,DUGGIRALA NAGESWARA RAO,Jatiya Jana Sena Party,39,0,39
40,9,NARESH KUMAR,Aapki Apni Party (Peoples),37,0,37
40,10,NITYA NAND SINGH,Rashtriya Manav Party,8,0,8
40,11,MUKESH JAIN,Rashtrawadi Janlok Party (Satya),8,0,8
40,12,DR. MUNISH KUMAR RAIZADA,Bharatiya Liberal Party,75,1,76
40,13,RAVINDER SINGH RAWAT,Haryana Jansena Party,14,1,15
40,14,SANGHA NAND BAUDDH,Bhim Sena,8,0,8
40,15,SANTOSH KUMAR,Right to Recall Party,30,0,30
40,16,SANTOSH RAI,Abhinav Bharat Party,53,0,53
40,17,ANITA,Independent,55,0,55
40,18,ANURADHA RANA,Independent,72,0,72
40,19,DR. ABHILASHA,Independent,31,0,31
40,20,PANKAJ SHARMA,Independent,9,0,9
40,21,BHAWANA,Independent,11,0,11
40,22,SANJAY RAWAT,Independent,16,1,17
40,23,HAIDER ALI,Independent,9,0,9
40,24,NOTA,None of the Above,306,8,314
41,1,TARVINDER SINGH MARWAH,Bharatiya Janata Party,38675,184,38859
41,2,FARHAD SURI,Indian National Congress,7324,26,7350
41,3,MANISH SISODIA,Aam Aadmi Party,38081,103,38184
41,4,RAVINDRA SINGH RAVIYODAYA,Bahujan Samaj Party,154,1,155
41,5,ANIL KUMAR,Bhartiya Rashtrawadi Party,74,0,74
41,6,BIJENDER,Haryana Jansena Party,119,0,119
41,7,RAKESH SAGAR,Blue India Party,78,0,78
41,8,ASHOK BAMBANI,Independent,170,1,171
41,9,SUNIL KUMAR KUKREJA,Independent,80,0,80
41,10,NOTA,None of the Above,438,3,441
42,1,ABHISHEK DUTT,Indian National Congress,26918,101,27019
42,2,NEERAJ BASOYA,Bharatiya Janata Party,37896,171,38067
42,3,MAHESH KUMAR,Bahujan Samaj Party,149,1,150
42,4,RAMESH PAHELWAN,Aam Aadmi Party,18558,59,18617
42,5,PARTEEK GUPTA,Independent,157,1,158
42,6,NOTA,None of the Above,470,2,472
43,1,CHARANJEET KAUR,Bahujan Samaj Party,237,1,238
43,2,JITENDER KUMAR KOCHAR,Indian National Congress,6734,36,6770
43,3,SATISH UPADHYAY,Bharatiya Janata Party,39216,348,39564
43,4,SOMNATH BHARTI,Aam Aadmi Party,37280,153,37433
43,5,BHAVISH DHANKAR,Bhartiya Rashtriya Jansatta,144,0,144
43,6,DR. BHUPENDRA CHAURASIYA,Yuva Bharat Rashtraseva Party,162,0,162
43,7,MEGHNAD S.,Independent,192,0,192
43,8,NOTA,None of the Above,526,6,532
44,1,ANIL KUMAR SHARMA,Bharatiya Janata Party,42965,295,43260
44,2,PRAMILA TOKAS,Aam Aadmi Party,28652,155,28807
44,3,VISHESH KUMAR,Indian National Congress,3048,31,3079
44,4,SUNIL KAIN,Bahujan Samaj Party,202,0,202
44,5,ABHA JHA,Bhartiya Mahasangh Party,25,0,25
44,6,NEERAJ CHOURASIYA,Yuva Bharat Rashtraseva Party,99,0,99
44,7,LOKESH KUMAR MASTERJI,Rashtriya Rashtrawadi Party,76,0,76
44,8,VIJAY KUMAR,Peoples Party of India (Democratic),52,0,52
44,9,SARAVANAN,Rashtriya Manav Party,35,0,35
44,10,KULDEEP SINGH AHLAWAT,Independent,55,0,55
44,11,PERMILA,Independent,87,1,88
44,12,RAMESH ADVOCATE,Independent,100,0,100
44,13,RAI SINGH,Independent,76,0,76
44,14,NOTA,None of the Above,545,4,549
45,1,GAJENDER SINGH YADAV,Bharatiya Janata Party,48022,327,48349
45,2,PUSHPA SINGH,Indian National Congress,9250,88,9338
45,3,MAHENDER CHAUDHARY,Aam Aadmi Party,46426,141,46567
45,4,YOGESHWAR SINGH BISHT,Bahujan Samaj Party,771,7,778
45,5,MAHAVIR SINGH,Matrubhoomi Sewa Party,181,0,181
45,6,VIJAY LAL TAMTA,Peoples Party of India (Democratic),104,0,104
45,7,SHARDA SINGH,Right to Recall Party,140,0,140
45,8,BALYOGI BABA BALAKNATH,Independent,9685,46,9731
45,9,NOTA,None of the Above,840,6,846
46,1,KARTAR SINGH TANWAR,Bharatiya Janata Party,80128,341,80469
46,2,BRIJ LAL,Bahujan Samaj Party,739,11,750
46,3,BRAHM SINGH TANWAR,Aam Aadmi Party,74029,201,74230
46,4,RAJENDER SINGH TANWAR,Indian National Congress,6550,51,6601
46,5,ISLAM ALI,Aazad Samaj Party (Kanshi Ram),180,1,181
46,6,RICHA KUMARI,Republican Sena,77,0,77
46,7,DINESH TANWAR,Aapki Apni Party (Peoples),293,0,293
46,8,NARENDER,Nationalist Congress Party,173,0,173
46,9,DAYA RAM GURJAR,Independent,164,3,167
46,10,DHARMENDER,Independent,268,1,269
46,11,SANJAY NEGI,Independent,220,1,221
46,12,NOTA,None of the Above,862,6,868
47,1,ASMITA,Bahujan Samaj Party,2569,12,2581
47,2,PREM CHAUHAN,Aam Aadmi Party,86774,115,86889
47,3,RAJESH CHAUHAN,Indian National Congress,12147,64,12211
47,4,DEEPAK TANWAR,Lok Janshakti Party(Ram Vilas),50124,85,50209
47,5,DEVIKA,Rashtriya Lok Janshakti Party,536,2,538
47,6,BACHAN RAM,Matrubhoomi Sewa Party,943,4,947
47,7,RAJA RAM,Bhartiya Rashtrawadi Party,2225,4,2229
47,8,NOTA,None of the Above,2116,14,2130
48,1,DR. AJAY DUTT,Aam Aadmi Party,46122,163,46285
48,2,KHUSHI RAM CHUNAR,Bharatiya Janata Party,41877,178,42055
48,3,JAI PRAKASH,Indian National Congress,7129,43,7172
48,4,SEWA DASS,Bahujan Samaj Party,390,7,397
48,5,ARUN,Haryana Jansena Party,302,0,302
48,6,GULSHAN BHARTI,Right to Recall Party,32,0,32
48,7,DARSAN SINGH,Aazad Samaj Party (Kanshi Ram),255,6,261
48,8,RAJIV KUMAR,Bhartiya Rashtrawadi Party,85,0,85
48,9,ASHOK KUMAR,Independent,101,1,102
48,10,NOTA,None of the Above,497,1,498
49,1,CHANDAN KUMAR CHOUDHARY,Bharatiya Janata Party,53980,69,54049
49,2,MOHD ZAKIULLAH,Bahujan Samaj Party,795,1,796
49,3,DINESH MOHANIYA,Aam Aadmi Party,53658,47,53705
49,4,HARSH CHOUDHARY,Indian National Congress,15840,23,15863
49,5,QAMAR ALI,Nationalist Congress Party,78,0,78
49,6,RAVINDER SINGH,Republican Sena,68,0,68
49,7,SIRAJUDDIN,Aazad Samaj Party (Kanshi Ram),83,0,83
49,8,SUDHIR NEGI,Matrubhoomi Sewa Party,143,0,143
49,9,JAGDISH KUMAR VERMA,Independent,195,0,195
49,10,MAHENDER KUMAR,Independent,136,0,136
49,11,SATPAL,Independent,61,0,61
49,12,NOTA,None of the Above,534,3,537
50,1,GARVIT SINGHVI,Indian National Congress,6677,34,6711
50,2,NIYATI CHOUDHARY,Bahujan Samaj Party,235,0,235
50,3,SHIKHA ROY,Bharatiya Janata Party,49370,224,49594
50,4,SAURABH BHARADWAJ,Aam Aadmi Party,46231,175,46406
50,5,RAMESH JAGANNATH SHAH,Delhi Janta Party,96,0,96
50,6,SATISH KUMAR GULLIYA,Bhartiya Rashtrawadi Party,171,0,171
50,7,NOTA,None of the Above,666,5,671
51,1,ALKA LAMBA,Indian National Congress,4367,25,4392
51,2,ATISHI,Aam Aadmi Party,52058,96,52154
51,3,PRITAM SINGH,Bahujan Samaj Party,421,0,421
51,4,RAMESH BIDHURI,Bharatiya Janata Party,48478,155,48633
51,5,TANYA SINGH,Bhartiya Rashtrawadi Party,193,0,193
51,6,DEEPAK KAPILA,Azad Adhikar Sena,173,1,174
51,7,RAJAN SINGH,Aam Janta Party (India),84,1,85
51,8,RAJESH KUMAR,Veer Janshakti Party,23,0,23
51,9,SANGH MITRA,Bhim Sena,28,0,28
51,10,IQBAL AHMED SIDDIQUI,Independent,31,0,31
51,11,PARVEEN CHOUDHRY,Independent,58,0,58
51,12,RAVI,Independent,39,0,39
51,13,SANJAY,Independent,89,0,89
51,14,NOTA,None of the Above,556,0,556
52,1,AMJAD HASAN,Bahujan Samaj Party,1604,2,1606
52,2,ROHTASH KUMAR,Bharatiya Janata Party,47362,82,47444
52,3,VIRENDER SINGH,Indian National Congress,2303,10,2313
52,4,SAHI RAM,Aam Aadmi Party,62073,82,62155
52,5,KHURSHEED ABBAS ZAIDI,Rashtriya Bahujan Congress Party,133,0,133
52,6,CHAMAN LAL,Peoples Party of India (Democratic),86,0,86
52,7,NARESH KUMAR,Right to Recall Party,199,0,199
52,8,PARVEEN CHAUHAN,Samata Party,323,0,323
52,9,REKHA SINGH,Independent,143,0,143
52,10,NOTA,None of the Above,534,2,536
53,1,ARJUN SINGH BHADANA,Indian National Congress,3135,10,3145
53,2,JAGDISH CHAND,Communist Party of India (Marxist),363,4,367
53,3,NARAYAN DUTT SHARMA,Bharatiya Janata Party,86865,238,87103
53,4,PARDEEP,Bahujan Samaj Party,1955,10,1965
53,5,RAM SINGH NETAJI,Aam Aadmi Party,112809,182,112991
53,6,IMRAN SAIFI,Nationalist Congress Party,322,0,322
53,7,BRIJPAL,Bharatiya Sampuran Krantikari Party,107,0,107
53,8,RAM BAHADUR,Akhil Bhartiya Manavatavadi Party,133,1,134
53,9,RAHUL RAI,Samata Party,466,0,466
53,10,HARI RAM,Rashtriya Bahujan Congress Party,185,0,185
53,11,OM PRAKASH GUPTA,Independent,176,0,176
53,12,DEEPAK RAWAT,Independent,219,0,219
53,13,NOTA,None of the Above,908,7,915
54,1,AMANATULLAH KHAN,Aam Aadmi Party,88751,192,88943
54,2,ARIBA KHAN,Indian National Congress,12638,101,12739
54,3,MANISH CHAUDHARY,Bharatiya Janata Party,65157,147,65304
54,4,SATISH KUMAR,Bahujan Samaj Party,755,1,756
54,5,MD INJAMAMUL HASSAN,Communist Party of India,259,0,259
54,6,MOHD ISLAM,Right to Recall Party,83,0,83
54,7,KANEEZ FATIMA,Aihra National Party,126,0,126
54,8,JAMALUDDIN,Buland Bharat Party,41,0,41
54,9,FIRDOS ALAM,Bhartiya Insan Party,148,0,148
54,10,RIZWANA KHATOON,Socialist Unity Centre Of India (COMMUNIST),221,0,221
54,11,SHIFA UR REHMAN KHAN,All India Majlis-E-Ittehadul Muslimeen,39498,60,39558
54,12,SHER MOHAMMAD,Azad Samaj Party,287,3,290
54,13,SHEIKH ARSALAN ULLAH CHISHTI,Independent,270,0,270
54,14,HAMMAD KHAN,Independent,180,0,180
54,15,NOTA,None of the Above,600,4,604
55,1,AMARDEEP,Indian National Congress,6115,32,6147
55,2,ANJANA PARCHA,Aam Aadmi Party,57692,133,57825
55,3,NAND LAL,Bahujan Samaj Party,1309,13,1322
55,4,RAVI KANT,Bharatiya Janata Party,58029,188,58217
55,5,VICKY,Aazad Samaj Party (Kanshi Ram),1677,4,1681
55,6,SARITA SINGH,Akhil Bharatiya Socialist Party,133,3,136
55,7,NAVEEN RAM,Independent,272,0,272
55,8,NOTA,None of the Above,679,4,683
56,1,AKSHAY KUMAR,Indian National Congress,7173,57,7230
56,2,KULDEEP KUMAR (MONU),Aam Aadmi Party,61609,183,61792
56,3,PRIYANKA GAUTAM,Bharatiya Janata Party,55243,256,55499
56,4,MUKESH KUMAR,Bahujan Samaj Party,2388,50,2438
56,5,AMARJEET PRASAD,Communist Party of India (Marxist-Leninist) (Liberation),94,6,100
56,6,ASHA KAMBLE,Republican Party of India (Athawale),188,0,188
56,7,NIKHIL KUMAR PIPAL,Right to Recall Party,121,1,122
56,8,SUNNY KUMAR,Aazad Samaj Party (Kanshi Ram),411,7,418
56,9,SURENDER SINGH,Swaraj Bhartiya Nyay Party,166,1,167
56,10,NOTA,None of the Above,771,5,776
57,1,ANIL KUMAR,Indian National Congress,16454,95,16549
57,2,AVADH OJHA,Aam Aadmi Party,45856,132,45988
57,3,OM SHANKAR PANDEY,Bahujan Samaj Party,747,9,756
57,4,Ravinder Singh Negi (Ravi Negi),Bharatiya Janata Party,73696,364,74060
57,5,GOPAL PRASAD,Delhi Janta Party,137,0,137
57,6,DEEPA DEVI,Aihra National Party,55,2,57
57,7,PRAKASH CHANDRA JOSHI,Bhartiya Rashtriya Jansatta,187,1,188
57,8,JAGDISH OJHA,Independent,108,0,108
57,9,DIBLU SINGH,Independent,114,3,117
57,10,NOTA,None of the Above,688,4,692
58,1,ABHAY VERMA,Bharatiya Janata Party,65560,298,65858
58,2,B B TYAGI,Aam Aadmi Party,54148,168,54316
58,3,MOHD WAQAR CHOUDHARY,Bahujan Samaj Party,382,6,388
58,4,SUMIT SHARMA,Indian National Congress,4277,39,4316
58,5,ANIMA OJHA,Right to Recall Party,45,0,45
58,6,ISMAIL,Voice of Awam Party,32,0,32
58,7,KUSUM LATA,Peoples Party of India (Democratic),44,2,46
58,8,GANDHI GAUTAM,Aazad Samaj Party (Kanshi Ram),172,1,173
58,9,DANVEER VIDYALANKAR,Rashtra Nirman Party,41,0,41
58,10,DEEPAK PANDEY,Magadh Congress of Inda,107,0,107
58,11,NAMAHA,Nationalist Congress Party,48,0,48
58,12,VIKAS,Aapsi Sahyog Party,133,2,135
58,13,ANURAG KUMAR,Independent,48,0,48
58,14,JAGDISH KUMAR GARG,Independent,74,0,74
58,15,VIMAL KUMAR SAXENA,Independent,69,0,69
58,16,NOTA,None of the Above,680,6,686
59,1,OM PRAKASH SHARMA,Bharatiya Janata Party,71672,469,72141
59,2,DEEPAK SINGHAL,Aam Aadmi Party,46955,144,47099
59,3,RAJIV CHAUDHARY,Indian National Congress,3576,51,3627
59,4,RAJESH KUMAR YADAV,Bahujan Samaj Party,436,7,443
59,5,ANIL KUMAR,National Youth Party,47,0,47
59,6,GURMEET SINGH,Jai Maha Bharath Party,161,0,161
59,7,DEEPAK KUMAR,Bharatiy Aam Janta Adhikar Party,47,2,49
59,8,NEELAM SINGH,Peoples Party of India (Democratic),49,0,49
59,9,PARAG JAIN,Aam Aadmi Parivartan Party,142,0,142
59,10,BHAWANA BOTHRA,Veer Janshakti Party,217,0,217
59,11,NOTA,None of the Above,1042,5,1047
60,1,DR ANIL GOYAL,Bharatiya Janata Party,75623,299,75922
60,2,AMAR SINGH,Bahujan Samaj Party,544,8,552
60,3,GURCHARAN SINGH (RAJU),Indian National Congress,9356,37,9393
60,4,VIKAS BAGGA CA,Aam Aadmi Party,56332,92,56424
60,5,POONAM MAINI,National Youth Party,131,0,131
60,6,VIDHAYAK VIRENDRA PRADHAN GURJAR,Samrat Mihir Bhoj Samaj Party,96,0,96
60,7,VINOD KAPOOR,Independent,191,0,191
60,8,NOTA,None of the Above,687,9,696
61,1,ARVINDER SINGH LOVELY,Bharatiya Janata Party,56665,193,56858
61,2,KAMAL ARORA (DABBU),Indian National Congress,3433,20,3453
61,3,TIKRAJ SINGH,Bahujan Samaj Party,235,0,235
61,4,NAVEEN CHAUDHARY (DEEPU),Aam Aadmi Party,44059,51,44110
61,5,PAWAN CHOUDHRY,Jatiya Jana Sena Party,190,0,190
61,6,GULFAM,Independent,156,0,156
61,7,NOTA,None of the Above,402,0,402
62,1,JAGAT SINGH,Indian National Congress,3834,28,3862
62,2,JITENDER SINGH SHUNTY,Aam Aadmi Party,57449,161,57610
62,3,DHARMINDRA KUMAR KAIM,Bahujan Samaj Party,586,10,596
62,4,SANJAY GOYAL,Bharatiya Janata Party,62477,311,62788
62,5,KAMAL KISHORE,National Youth Party,145,0,145
62,6,NITIN GARG,Aam Aadmi Parivartan Party,181,1,182
62,7,RAJENDRA KUMAR PAL,Nationalist Congress Party,58,0,58
62,8,ASHOK SURANA,Independent,87,0,87
62,9,DILIP BANERJEE,Independent,52,0,52
62,10,VINAY CHAUDHARI,Independent,577,2,579
62,11,NOTA,None of the Above,555,3,558
63,1,MANOJ,Bahujan Samaj Party,855,12,867
63,2,RAJESH LILOTHIA,Indian National Congress,11788,35,11823
63,3,KU. RINKU,Bharatiya Janata Party,55766,219,55985
63,4,VEER SINGH DHINGAN,Aam Aadmi Party,66186,167,66353
63,5,AJAY KUMAR,Peoples Party of India (Democratic),276,1,277
63,6,ANIL KUMAR,Aazad Samaj Party (Kanshi Ram),650,4,654
63,7,CHARAN SINGH MALIYAN,Right to Recall Party,58,0,58
63,8,RAJESH,Bharatiya Sarvodaya Kranti Party,50,1,51
63,9,RAJESH KUMAR LOHIYA,Nationalist Congress Party,110,0,110
63,10,SAROJ BALA,Swatantra Jantaraj Party,163,0,163
63,11,ASHISH KUMAR,Independent,158,0,158
63,12,NOTA,None of the Above,453,5,458
64,1,ASHOK KUMAR,Bahujan Samaj Party,930,23,953
64,2,JITENDER MAHAJAN,Bharatiya Janata Party,82299,597,82896
64,3,SARITA SINGH,Aam Aadmi Party,54803,191,54994
64,4,SURESHVATI,Indian National Congress,3604,35,3639
64,5,AKESHAN DUT,Bhartiya Rashtriya Dal,48,0,48
64,6,ABHISHEK,Nationalist Congress Party,91,0,91
64,7,AMIT KUMAR SHARMA,Sanjhi Virasat Party,42,1,43
64,8,NASEEM USMAN,Bharatiya Liberal Party,63,0,63
64,9,PANKAJ GUPTA,Sarvodaya Prabhat Party,54,0,54
64,10,SUBHASH CHAND GUPTA,Bhartiya Rashtrawadi Party,30,0,30
64,11,SURENDER SINGH VISHWAKARMA,Aazad Samaj Party (Kanshi Ram),172,2,174
64,12,SANJEEV KUMAR,Jan Samuh Party,34,1,35
64,13,NITIN MITTAL,Independent,45,0,45
64,14,VIKAS TYAGI,Independent,548,2,550
64,15,SURESH PAL JAINTH,Independent,72,0,72
64,16,NOTA,None of the Above,628,2,630
65,1,ANIL KUMAR SHARMA (GAUR),Bharatiya Janata Party,36353,179,36532
65,2,ABDUL REHMAN,Indian National Congress,16524,27,16551
65,3,CHAUDHARY ZUBAIR AHMAD,Aam Aadmi Party,78866,143,79009
65,4,DEEPAK KUMAR,Bahujan Samaj Party,415,7,422
65,5,MOHD NAZIR,Republican Party of India (Athawale),107,0,107
65,6,SHABANA,Rashtriya Republican Party,177,0,177
65,7,SUMAN SHARMA,Sanjhi Virasat Party,50,0,50
65,8,S. M. AQIF,Independent,24,0,24
65,9,ISLAUDDIN,Independent,22,0,22
65,10,MOHD ZUBAIR MALIK,Independent,29,0,29
65,11,RAHISUDDIN AHMAD,Independent,44,0,44
65,12,MOHD SHAFI,Independent,72,0,72
65,13,SYED MUNEEB,Independent,46,0,46
65,14,NOTA,None of the Above,353,2,355
66,1,AJAY MAHAWAR,Bharatiya Janata Party,79706,281,79987
66,2,GAURAV SHARMA,Aam Aadmi Party,53828,101,53929
66,3,BHISHAM SHARMA,Indian National Congress,4859,24,4883
66,4,SUNDER LOHIYA,Bahujan Samaj Party,448,6,454
66,5,ANIL SINGH,Sanjhi Virasat Party,56,0,56
66,6,BABITA,Yuva Bharat Rashtraseva Party,114,0,114
66,7,ADVOCATE MEHAK DOGRA,Nationalist Congress Party,44,2,46
66,8,SHUBHAM,Right to Recall Party,84,0,84
66,9,GAURAV SHARMA,Independent,277,2,279
66,10,NOTA,None of the Above,587,1,588
67,1,ANIL KUMAR VASHISHT,Bharatiya Janata Party,56758,440,57198
67,2,GOPAL RAI,Aam Aadmi Party,76031,161,76192
67,3,MOHD ISHRAQ KHAN,Indian National Congress,8777,20,8797
67,4,BHUPENDER YADAV,Janhit Dal,93,0,93
67,5,MD NAZIR,Aman Samaj Party,201,0,201
67,6,MANOJ KUMAR,Akhil Bharatiya Socialist Party,75,1,76
67,7,SHIV KUMAR(KAKE),Sarvodaya Prabhat Party,89,0,89
67,8,MOHAMMAD ABDULLAH ANSARI,Independent,124,0,124
67,9,NOTA,None of the Above,471,3,474
68,1,ISHWAR SINGH,Indian National Congress,5840,65,5905
68,2,PRAVEEN NIMESH,Bharatiya Janata Party,71764,533,72297
68,3,LAL SINGH,Bahujan Samaj Party,2518,44,2562
68,4,SURENDRA KUMAR,Aam Aadmi Party,80086,418,80504
68,5,ATUL KUMAR,Swaraj Bhartiya Nyay Party,335,4,339
68,6,ARVIND KUMAR,Aazad Samaj Party (Kanshi Ram),3049,37,3086
68,7,CHARAN SINGH MALIYAN,Right to Recall Party,91,0,91
68,8,JAGDISH,Nationalist Congress Party,64,0,64
68,9,DHARAMVIR SINGH,Peoples Party of India (Democratic),193,2,195
68,10,BIR SAIN,Bharatiya Sarvodaya Kranti Party,145,0,145
68,11,MANJEET SINGH,Jan Samuh Party,125,4,129
68,12,SURESHPAL JAINTH,Independent,130,3,133
68,13,NOTA,None of the Above,589,12,601
69,1,ALI MEHDI,Indian National Congress,11732,31,11763
69,2,ASHOK KUMAR,Bahujan Samaj Party,1201,22,1223
69,3,ADEEL AHMAD KHAN,Aam Aadmi Party,67511,126,67637
69,4,MOHAN SINGH BISHT,Bharatiya Janata Party,84888,327,85215
69,5,ASHA CHAUDHARY,Bharatiya Sampuran Krantikari Party,236,0,236
69,6,MOHD USMAN BAKHSH,Rashtriya Janmorcha,151,0,151
69,7,MOHD. TAHIR HUSSAIN,All India Majlis-E-Ittehadul Muslimeen,33467,7,33474
69,8,DHARAM PAL,Bharatiya Sarvodaya Kranti Party,391,0,391
69,9,NASIRUDDIN GAURI,Rashtriya Republican Party,75,0,75
69,10,VISHAL,Peoples Party of India (Democratic),191,1,192
69,11,SAGAR TANHA,Peace Party,227,0,227
69,12,JITENDER KUMAR,Independent,122,0,122
69,13,NOTA,None of the Above,451,4,455
70,1,ASHOK AGARWAL,Communist Party of India (Marxist),456,1,457
70,2,KAPIL MISHRA,Bharatiya Janata Party,106963,404,107367
70,3,DEVENDRA BHAIYA,Bahujan Samaj Party,1876,11,1887
70,4,MANOJ KUMAR TYAGI,Aam Aadmi Party,83843,169,84012
70,5,DR. P.K. MISHRA,Indian National Congress,3908,13,3921
70,6,NEERAJ,New India United Party,100,0,100
70,7,PRAKASH CHAND,Bahujan Dravida Party,278,0,278
70,8,YOGENDER,Bharatiya Sampuran Krantikari Party,89,1,90
70,9,SEEMA,Peoples Party of India (Democratic),128,0,128
70,10,SANJAY MISHRA (SITARAM),Nationalist Congress Party,165,0,165
70,11,SANDHIYA TIWARI,Akhil Bharatiya Socialist Party,70,1,71
70,12,H.M. HASHIM MALIK,Social Democratic Party Of India,491,0,491
70,13,AJAY SINGH NEGI,Independent,1002,4,1006
70,14,YOGESH SWAMY,Independent,228,1,229
70,15,VISHAL SHARMA,Independent,173,0,173
70,16,NOTA,None of the Above,706,3,709
